inside:true
objects:none
warps:2,7,mar_a_lago,4,4
connections:none
wild:none
conditions:
configuration:
0133,0132,0132,0132,0132,0132,0132,0133
0133,0130,0130,0130,0130,0130,0130,0133
0133,0130,0130,0130,0130,0130,0130,0133
0133,0130,0130,0130,0130,0130,0130,0133
0133,0130,0130,0130,0130,0130,0130,0133
0133,0130,0130,0130,0130,0130,0130,0133
0133,0130,0130,0130,0130,0130,0130,0133
0133,0133,0130,0133,0133,0133,0133,0133