inside:false
objects:none
warps:none
connections:west,route_4,-5
wild:none
conditions:none
configuration:
0134,0136,0136,0136,0136,0136,0136,0136,0136,0136,0136,0136,0136,0136,0136,0136,0136,0136,0136,0136,0136,0136,0136,0136,0136,0136,0136,0136,0136,0134
0135,0122,0123,0123,0123,0123,0123,0123,0123,0123,0123,0123,0123,0123,0123,0123,0123,0123,0123,0123,0123,0123,0123,0123,0123,0123,0123,0123,0124,0135
0136,0125,0008,0171,0172,0172,0172,0173,0008,0008,0008,0008,0008,0008,0008,0008,0008,0008,0008,0008,0008,0008,0008,0008,0008,0008,0008,0008,0126,0136
0134,0125,0008,0174,0175,0176,0177,0178,0008,0008,0008,0008,0008,0008,0008,0008,0008,0008,0008,0008,0008,0008,0008,0008,0008,0008,0008,0008,0126,0134
0135,0125,0008,0179,0180,0181,0180,0182,0008,0008,0008,0008,0008,0008,0008,0008,0008,0008,0008,0008,0008,0008,0008,0008,0008,0008,0008,0008,0126,0135
0136,0125,0008,0008,0008,0008,0008,0008,0008,0008,0008,0008,0008,0008,0008,0008,0008,0008,0008,0008,0008,0008,0008,0008,0008,0008,0008,0008,0126,0136
0134,0125,0008,0008,0008,0008,0008,0008,0008,0008,0008,0008,0008,0008,0008,0008,0008,0008,0008,0008,0008,0008,0008,0008,0008,0008,0008,0008,0126,0134
0135,0125,0008,0008,0008,0008,0008,0008,0008,0008,0008,0008,0008,0008,0008,0008,0008,0008,0008,0008,0008,0008,0008,0008,0008,0008,0008,0008,0126,0135
0136,0125,0008,0008,0008,0008,0008,0008,0008,0008,0008,0008,0008,0008,0008,0008,0008,0008,0008,0008,0008,0008,0008,0008,0008,0008,0008,0008,0126,0136
0134,0125,0008,0008,0008,0008,0008,0008,0008,0008,0008,0008,0008,0008,0008,0008,0008,0008,0008,0008,0008,0008,0008,0008,0008,0008,0008,0008,0126,0134
0135,0125,0008,0008,0008,0008,0008,0008,0008,0008,0008,0008,0008,0008,0008,0008,0008,0008,0008,0008,0008,0008,0008,0008,0008,0008,0008,0008,0126,0135
0136,0125,0008,0008,0008,0008,0008,0008,0008,0008,0008,0008,0008,0008,0008,0008,0008,0008,0008,0008,0008,0008,0008,0008,0008,0008,0008,0008,0126,0136
0134,0125,0008,0008,0008,0008,0008,0008,0008,0008,0008,0008,0008,0008,0008,0008,0008,0008,0008,0008,0008,0008,0008,0008,0008,0008,0008,0008,0126,0134
0135,0125,0008,0008,0008,0008,0008,0008,0008,0008,0008,0008,0008,0008,0008,0008,0008,0008,0008,0008,0008,0008,0008,0008,0008,0008,0008,0008,0126,0135
0136,0125,0008,0008,0008,0008,0008,0008,0008,0008,0008,0008,0008,0008,0008,0008,0008,0008,0008,0008,0008,0008,0008,0008,0008,0008,0008,0008,0126,0136
0134,0125,0008,0008,0008,0008,0008,0008,0008,0008,0008,0008,0008,0008,0008,0008,0008,0008,0008,0008,0008,0008,0008,0008,0008,0008,0008,0008,0126,0134
0135,0125,0008,0008,0008,0008,0008,0008,0008,0008,0008,0008,0008,0008,0008,0008,0008,0008,0008,0008,0008,0008,0008,0008,0008,0008,0008,0008,0126,0135
0136,0125,0008,0008,0008,0008,0008,0008,0008,0008,0008,0008,0008,0008,0008,0008,0008,0008,0008,0008,0008,0008,0008,0008,0008,0008,0008,0008,0126,0136
0134,0125,0008,0008,0008,0008,0008,0008,0008,0008,0008,0008,0008,0008,0008,0008,0008,0008,0008,0008,0008,0008,0008,0008,0008,0008,0008,0008,0126,0134
0135,0125,0008,0008,0008,0008,0008,0008,0008,0008,0008,0008,0008,0008,0008,0008,0008,0008,0008,0008,0008,0008,0008,0008,0008,0008,0008,0008,0126,0135
0136,0125,0008,0008,0008,0008,0008,0008,0008,0008,0008,0008,0008,0008,0008,0008,0008,0008,0008,0008,0008,0008,0008,0008,0008,0008,0008,0008,0126,0136
0005,0125,0008,0008,0008,0008,0158,0159,0160,0008,0008,0165,0166,0167,0008,0008,0008,0008,0008,0008,0008,0008,0008,0008,0008,0008,0008,0008,0126,0134
0005,0125,0008,0008,0008,0008,0161,0075,0162,0008,0008,0168,0169,0170,0008,0008,0008,0008,0008,0008,0008,0008,0008,0008,0008,0008,0008,0008,0126,0135
0005,0125,0008,0008,0008,0008,0163,0078,0164,0008,0008,0163,0078,0164,0008,0008,0008,0008,0008,0008,0008,0008,0008,0008,0008,0008,0008,0008,0126,0136
0005,0125,0008,0008,0008,0008,0008,0008,0008,0008,0008,0008,0008,0008,0008,0008,0008,0008,0008,0008,0008,0008,0008,0008,0008,0008,0008,0008,0126,0134
0134,0125,0008,0008,0008,0008,0008,0008,0008,0008,0008,0008,0008,0008,0008,0008,0008,0008,0008,0008,0008,0008,0008,0008,0008,0008,0008,0008,0126,0135
0135,0125,0008,0008,0008,0008,0008,0008,0008,0008,0008,0008,0008,0008,0008,0008,0008,0008,0008,0008,0008,0008,0008,0008,0008,0008,0008,0008,0126,0136
0135,0125,0008,0008,0008,0008,0008,0008,0008,0008,0008,0008,0008,0008,0008,0008,0008,0008,0008,0008,0008,0008,0008,0008,0008,0008,0008,0008,0126,0134
0135,0127,0128,0128,0128,0128,0128,0128,0128,0128,0128,0128,0128,0128,0128,0128,0128,0128,0128,0128,0128,0128,0128,0128,0128,0128,0128,0128,0129,0135
0136,0134,0134,0134,0134,0134,0134,0134,0134,0134,0134,0134,0134,0134,0134,0134,0134,0134,0134,0134,0134,0134,0134,0134,0134,0134,0134,0134,0134,0136