inside:false
objects:none
warps:4,17,lab_inside,4,10
connections:north,mar_a_lago,-2
wild:grass,5,5,1
conditions:none|none
configuration:
0100,0100,0100,0100,0100,0100,0100,0100,0100
0080,0080,0080,0093,0093,0093,0080,0080,0080
0080,0080,0080,0093,0093,0093,0080,0080,0080
0080,0080,0080,0093,0093,0093,0080,0080,0080
0080,0080,0080,0093,0093,0093,0080,0080,0080
0080,0080,0080,0093,0093,0093,0080,0080,0080
0080,0080,0080,0093,0093,0093,0080,0080,0080
0080,0080,0080,0093,0093,0093,0080,0080,0080
0080,0080,0080,0093,0093,0093,0080,0080,0080
0080,0080,0080,0093,0093,0093,0080,0080,0080
0080,0080,0080,0093,0093,0093,0080,0080,0080
0080,0080,0080,0093,0093,0093,0080,0080,0080
0080,0080,0080,0093,0093,0093,0080,0080,0080
0080,0094,0095,0095,0095,0095,0095,0096,0080
0080,0097,0005,0005,0005,0005,0005,0098,0080
0080,0097,0005,0084,0085,0086,0005,0098,0080
0080,0097,0005,0087,0088,0089,0005,0098,0080
0080,0097,0005,0090,0091,0092,0005,0098,0080
0080,0099,0100,0100,0100,0100,0100,0101,0080
0080,0080,0080,0080,0080,0080,0080,0080,0080