height:10
width:10
wild:grass,3.6,1|water,1.2,1,None
objects:
warps:4,0|4,8|playerhouse2|rough/4,9|4,1|playerhouse2|rough
events:
configuration:
2,1,1,1,1,1,1,1,1,2
2,1,1,1,1,1,1,1,1,2
2,1,1,1,1,1,1,1,1,2
2,1,1,1,1,1,1,1,1,2
1,1,1,1,1,1,1,1,1,1
2,1,1,1,2,2,2,1,1,2
2,1,1,1,2,1,2,1,1,2
2,1,1,1,2,2,2,1,1,2
2,1,1,1,3,3,1,1,1,2
2,1,1,1,3,3,3,1,1,2