inside:false
objects:none
warps:6,9,player_house,4,9|10,8,mexican_house,2,3|4,4,guest_house,2,7
connections:south,lab_outside,2|north,route_1,0
wild:grass,5,5,1
conditions:none|none
configuration:
0136,0005,0005,0005,0005,0005,0005,0005,0005,0005,0005,0136,0136,0136
0134,0005,0005,0005,0005,0005,0005,0005,0053,0054,0055,0056,0005,0134
0135,0005,0005,0005,0005,0005,0005,0005,0057,0058,0059,0060,0005,0135
0136,0005,0005,0045,0046,0047,0048,0005,0061,0062,0063,0064,0005,0136
0134,0005,0005,0049,0050,0051,0052,0005,0005,0065,0066,0005,0005,0134
0136,0005,0005,0005,0043,0044,0005,0005,0005,0042,0005,0005,0005,0136
0134,0005,0005,0009,0010,0011,0012,0013,0014,0015,0005,0005,0005,0134
0136,0005,0005,0016,0017,0018,0019,0020,0021,0022,0023,0024,0005,0136
0134,0005,0005,0025,0026,0027,0028,0029,0030,0031,0032,0033,0005,0134
0136,0005,0005,0034,0035,0036,0037,0038,0039,0040,0041,0005,0005,0136
0134,0005,0005,0005,0005,0005,0005,0005,0005,0005,0005,0005,0005,0134
0135,0005,0005,0005,0005,0005,0005,0005,0005,0005,0005,0005,0005,0135
0136,0134,0005,0005,0005,0005,0005,0005,0005,0005,0005,0134,0134,0136