inside:false
objects:none
warps:6,23,okeechobee_poke,5,10
connections:south,route_2,-3|east,route_3,0
wild:none
conditions:
configuration:
0134,0136,0136,0136,0136,0136,0136,0136,0136,0136,0136,0136,0136,0136,0136,0136,0136,0136,0136,0136,0136,0136,0136,0136,0136,0136,0136,0136,0136,0134
0136,0005,0005,0005,0005,0005,0005,0005,0005,0005,0005,0005,0005,0005,0005,0005,0005,0005,0005,0005,0005,0005,0005,0005,0005,0005,0005,0005,0005,0136
0134,0005,0005,0005,0005,0005,0005,0005,0005,0005,0005,0005,0005,0005,0005,0005,0005,0005,0005,0005,0005,0005,0005,0005,0005,0005,0005,0005,0005,0005
0136,0005,0005,0005,0005,0005,0005,0005,0005,0005,0005,0005,0005,0005,0005,0005,0005,0005,0005,0005,0005,0005,0005,0005,0005,0005,0005,0005,0005,0005
0134,0005,0005,0005,0005,0005,0005,0005,0005,0005,0005,0005,0005,0005,0005,0005,0005,0005,0005,0005,0005,0005,0005,0005,0005,0005,0005,0005,0005,0005
0136,0005,0005,0005,0005,0005,0005,0005,0005,0005,0005,0005,0005,0005,0005,0005,0005,0005,0005,0005,0005,0005,0005,0005,0005,0005,0005,0005,0005,0005
0134,0005,0005,0005,0005,0005,0005,0005,0005,0005,0005,0005,0005,0005,0005,0005,0005,0005,0005,0005,0005,0005,0005,0005,0005,0005,0005,0005,0005,0005
0136,0005,0005,0005,0005,0005,0005,0005,0005,0005,0005,0005,0005,0005,0005,0005,0005,0005,0005,0005,0005,0005,0005,0005,0005,0005,0005,0005,0005,0005
0134,0005,0005,0005,0005,0005,0005,0005,0005,0005,0005,0005,0005,0005,0005,0005,0005,0005,0005,0005,0005,0005,0005,0005,0005,0005,0005,0005,0005,0134
0136,0005,0005,0005,0005,0005,0005,0005,0005,0005,0005,0005,0005,0005,0005,0005,0005,0005,0005,0005,0005,0005,0005,0005,0005,0005,0005,0005,0005,0136
0134,0005,0005,0005,0005,0005,0005,0005,0005,0005,0005,0005,0005,0005,0005,0005,0005,0005,0005,0005,0005,0005,0005,0005,0005,0005,0005,0005,0005,0134
0136,0005,0005,0005,0005,0005,0005,0005,0005,0005,0005,0005,0005,0005,0005,0005,0005,0005,0005,0005,0005,0005,0005,0005,0005,0005,0005,0005,0005,0136
0134,0005,0005,0005,0005,0005,0005,0005,0005,0005,0005,0005,0005,0005,0005,0005,0005,0005,0005,0005,0005,0005,0005,0005,0005,0005,0005,0005,0005,0134
0136,0005,0005,0005,0005,0005,0005,0005,0005,0005,0005,0005,0005,0005,0005,0005,0005,0005,0005,0005,0005,0005,0005,0005,0005,0005,0005,0005,0005,0136
0134,0005,0005,0005,0005,0005,0005,0005,0005,0005,0005,0005,0005,0005,0005,0005,0005,0005,0005,0005,0005,0005,0005,0005,0005,0005,0005,0005,0005,0134
0136,0005,0005,0005,0005,0005,0005,0005,0005,0005,0005,0005,0005,0005,0005,0005,0005,0005,0005,0005,0005,0005,0005,0005,0005,0005,0005,0005,0005,0136
0134,0005,0005,0005,0005,0005,0005,0005,0005,0005,0005,0005,0005,0005,0005,0005,0005,0005,0005,0005,0005,0005,0005,0005,0005,0005,0005,0005,0005,0134
0136,0005,0005,0005,0005,0005,0005,0005,0005,0005,0005,0005,0005,0005,0005,0005,0005,0005,0005,0005,0005,0005,0005,0005,0005,0005,0005,0005,0005,0136
0134,0005,0005,0005,0005,0005,0005,0005,0005,0005,0005,0005,0005,0005,0005,0005,0005,0005,0005,0005,0005,0005,0005,0005,0005,0005,0005,0005,0005,0134
0136,0005,0005,0005,0005,0005,0005,0005,0005,0005,0005,0005,0005,0005,0005,0005,0005,0005,0005,0005,0005,0005,0005,0005,0005,0005,0005,0005,0005,0136
0134,0005,0005,0005,0005,0005,0005,0005,0005,0005,0005,0005,0005,0005,0005,0005,0005,0005,0005,0005,0005,0005,0005,0005,0005,0005,0005,0005,0005,0134
0136,0005,0005,0005,0005,0071,0072,0073,0005,0005,0005,0005,0005,0005,0005,0005,0005,0005,0005,0005,0005,0005,0005,0005,0005,0005,0005,0005,0005,0136
0134,0005,0005,0005,0005,0074,0075,0076,0005,0005,0005,0005,0005,0005,0005,0005,0005,0005,0005,0005,0005,0005,0005,0005,0005,0005,0005,0005,0005,0134
0136,0005,0005,0005,0005,0077,0078,0079,0005,0005,0005,0005,0005,0005,0005,0005,0005,0005,0005,0005,0005,0005,0005,0005,0005,0005,0005,0005,0005,0136
0134,0005,0005,0005,0005,0005,0005,0005,0005,0005,0005,0005,0005,0005,0005,0005,0005,0005,0005,0005,0005,0005,0005,0005,0005,0005,0005,0005,0005,0134
0136,0005,0005,0005,0005,0005,0005,0005,0005,0005,0005,0005,0005,0005,0005,0005,0005,0005,0005,0005,0005,0005,0005,0005,0005,0005,0005,0005,0005,0136
0134,0005,0005,0005,0005,0005,0005,0005,0005,0005,0005,0005,0005,0005,0005,0005,0005,0005,0005,0005,0005,0005,0005,0005,0005,0005,0005,0005,0005,0134
0136,0005,0005,0005,0005,0005,0005,0005,0005,0005,0005,0005,0005,0005,0005,0005,0005,0005,0005,0005,0005,0005,0005,0005,0005,0005,0005,0005,0005,0136
0134,0134,0005,0005,0005,0005,0134,0134,0134,0134,0134,0134,0134,0134,0134,0134,0134,0134,0134,0134,0134,0134,0134,0134,0134,0134,0134,0134,0134,0134
0136,0136,0005,0005,0005,0005,0136,0136,0136,0136,0136,0136,0136,0136,0136,0136,0136,0136,0136,0136,0136,0136,0136,0136,0136,0136,0136,0136,0136,0136