inside:false
objects:none
warps:5,10,okeechobee,6,23
connections:none
wild:none
conditions:
configuration:
0132,0132,0132,0132,0132,0132,0132,0132,0132,0132,0132
0130,0130,0130,0130,0130,0130,0130,0130,0130,0130,0130
0130,0130,0130,0130,0130,0130,0130,0130,0130,0130,0130
0130,0130,0130,0130,0130,0130,0130,0130,0130,0130,0130
0130,0130,0130,0130,0130,0130,0130,0130,0130,0130,0130
0130,0130,0130,0130,0130,0130,0130,0130,0130,0130,0130
0130,0130,0130,0130,0130,0130,0130,0130,0130,0130,0130
0130,0130,0130,0130,0130,0130,0130,0130,0130,0130,0130
0130,0130,0130,0130,0130,0130,0130,0130,0130,0130,0130
0130,0130,0130,0130,0130,0130,0130,0130,0130,0130,0130
0133,0133,0133,0133,0133,0130,0133,0133,0133,0133,0133