inside:false
objects:none
warps:2,21,pie_cavern_bottom,2,21|12,8,pie_cavern_bottom,12,8|16,45,pie_cavern_bottom,16,45|22,2,pie_cavern_bottom,22,2|51,58,pie_cavern_bottom,51,58|58,55,pie_cavern_bottom,58,55|45,2,pie_cavern_bottom,45,2|45,11,pie_cavern_bottom,45,11|22,22,pie_cavern_bottom,22,22|0,1,route_3,22,5|59,58,route_4,2,2
connections:none
wild:none
conditions:none
configuration:
0143,0143,0143,0143,0143,0143,0143,0143,0143,0143,0143,0144,0133,0133,0133,0133,0133,0133,0133,0133,0142,0143,0143,0143,0143,0143,0143,0143,0143,0143,0144,0133,0133,0133,0133,0133,0133,0133,0133,0133,0133,0133,0133,0133,0142,0143,0143,0143,0143,0143,0143,0143,0143,0143,0143,0143,0143,0143,0143,0144
0141,0141,0141,0141,0141,0141,0141,0141,0141,0141,0141,0146,0133,0133,0133,0133,0133,0133,0133,0133,0145,0141,0141,0141,0141,0141,0141,0141,0141,0141,0152,0144,0133,0133,0133,0133,0133,0133,0133,0133,0133,0133,0133,0133,0145,0141,0141,0141,0141,0141,0141,0141,0141,0141,0141,0141,0141,0141,0141,0146
0151,0141,0141,0150,0148,0148,0148,0148,0148,0148,0148,0149,0133,0133,0133,0133,0133,0133,0133,0133,0145,0141,0154,0141,0141,0141,0141,0141,0141,0141,0141,0143,0144,0133,0133,0133,0133,0133,0133,0133,0133,0133,0133,0133,0145,0154,0141,0141,0141,0141,0141,0141,0141,0141,0141,0141,0141,0141,0141,0146
0145,0141,0141,0146,0133,0133,0133,0133,0133,0133,0133,0133,0133,0133,0133,0133,0133,0133,0133,0133,0145,0141,0141,0141,0141,0141,0141,0141,0141,0141,0141,0141,0152,0144,0133,0133,0133,0133,0133,0133,0133,0133,0133,0133,0147,0148,0148,0148,0148,0148,0151,0141,0141,0141,0141,0141,0141,0141,0141,0146
0145,0141,0141,0146,0133,0133,0133,0133,0133,0133,0133,0133,0133,0133,0133,0133,0133,0133,0133,0133,0145,0141,0141,0141,0141,0141,0141,0141,0141,0141,0141,0141,0141,0152,0144,0133,0133,0133,0133,0133,0133,0133,0133,0133,0133,0133,0133,0133,0133,0133,0147,0151,0141,0141,0141,0141,0141,0141,0141,0146
0145,0141,0141,0146,0133,0133,0133,0133,0133,0133,0133,0133,0133,0133,0133,0133,0133,0133,0133,0133,0145,0141,0141,0141,0141,0141,0141,0141,0141,0141,0141,0141,0141,0141,0152,0143,0144,0133,0133,0133,0133,0133,0133,0133,0133,0133,0133,0133,0133,0133,0133,0147,0151,0141,0141,0141,0141,0141,0141,0146
0145,0141,0141,0146,0133,0133,0133,0133,0133,0133,0133,0133,0133,0133,0133,0133,0133,0133,0133,0133,0147,0148,0148,0148,0148,0151,0141,0141,0141,0141,0141,0141,0141,0141,0141,0141,0152,0144,0133,0133,0133,0133,0133,0133,0133,0133,0133,0133,0133,0133,0133,0133,0147,0148,0151,0141,0141,0141,0141,0146
0145,0141,0141,0152,0144,0133,0133,0133,0133,0133,0133,0142,0143,0143,0143,0144,0133,0133,0133,0133,0133,0133,0133,0133,0133,0147,0148,0148,0151,0141,0141,0141,0141,0141,0141,0141,0141,0152,0144,0133,0133,0133,0133,0133,0133,0133,0133,0133,0133,0133,0133,0133,0133,0133,0147,0151,0141,0141,0141,0146
0145,0141,0141,0141,0146,0133,0133,0133,0133,0133,0133,0145,0154,0141,0141,0146,0133,0133,0133,0133,0133,0133,0133,0133,0133,0133,0133,0133,0145,0141,0141,0141,0141,0141,0141,0141,0141,0141,0152,0144,0133,0133,0133,0133,0133,0133,0133,0133,0133,0133,0133,0133,0133,0133,0133,0145,0141,0141,0141,0146
0145,0141,0141,0141,0146,0133,0133,0133,0133,0133,0133,0147,0148,0148,0148,0149,0133,0133,0133,0133,0133,0133,0133,0133,0133,0133,0133,0133,0145,0141,0141,0141,0141,0141,0141,0141,0141,0141,0141,0152,0143,0144,0133,0133,0133,0133,0133,0133,0133,0133,0133,0133,0133,0133,0133,0147,0151,0141,0141,0146
0145,0141,0141,0141,0152,0144,0133,0133,0133,0133,0133,0133,0133,0133,0133,0133,0133,0133,0133,0133,0133,0133,0133,0133,0133,0133,0133,0133,0147,0151,0141,0141,0141,0141,0141,0141,0141,0141,0141,0141,0141,0152,0143,0143,0143,0143,0144,0133,0133,0133,0133,0133,0133,0133,0133,0133,0147,0151,0141,0146
0145,0141,0141,0141,0141,0152,0143,0144,0133,0133,0133,0133,0133,0133,0133,0133,0133,0133,0133,0133,0133,0133,0133,0133,0133,0133,0133,0133,0133,0147,0151,0141,0141,0141,0141,0141,0141,0141,0141,0141,0141,0141,0141,0141,0141,0154,0146,0133,0133,0133,0133,0133,0133,0133,0133,0133,0133,0145,0141,0146
0145,0141,0141,0141,0141,0141,0141,0152,0144,0133,0133,0133,0133,0133,0133,0133,0133,0133,0133,0133,0133,0133,0133,0133,0133,0133,0133,0133,0133,0133,0147,0151,0141,0141,0141,0141,0141,0141,0141,0141,0150,0148,0148,0148,0148,0148,0149,0133,0133,0133,0133,0133,0133,0133,0133,0133,0133,0145,0141,0146
0145,0141,0141,0141,0141,0141,0141,0141,0146,0133,0133,0133,0133,0133,0133,0133,0133,0133,0133,0133,0133,0133,0133,0133,0133,0133,0133,0133,0133,0133,0133,0147,0151,0141,0141,0141,0141,0141,0141,0150,0149,0133,0133,0133,0133,0133,0133,0133,0133,0133,0133,0133,0133,0133,0133,0133,0142,0153,0141,0146
0145,0141,0141,0141,0141,0141,0141,0150,0149,0133,0133,0133,0133,0133,0133,0133,0133,0133,0133,0133,0133,0133,0133,0133,0133,0133,0133,0133,0133,0133,0133,0133,0147,0151,0141,0141,0141,0141,0150,0149,0133,0133,0133,0133,0133,0133,0133,0133,0133,0133,0133,0133,0133,0133,0133,0133,0145,0141,0141,0146
0145,0141,0141,0141,0141,0141,0141,0146,0133,0133,0133,0133,0133,0133,0133,0133,0133,0133,0133,0142,0143,0143,0143,0143,0144,0133,0133,0133,0133,0133,0133,0133,0133,0147,0148,0148,0148,0148,0149,0133,0133,0133,0133,0133,0133,0133,0133,0133,0133,0133,0133,0133,0133,0133,0142,0143,0153,0141,0141,0146
0145,0141,0141,0141,0141,0150,0148,0149,0133,0133,0133,0133,0133,0133,0133,0133,0133,0133,0142,0153,0141,0141,0141,0141,0152,0144,0133,0133,0133,0133,0133,0133,0133,0133,0133,0133,0133,0133,0133,0133,0133,0133,0133,0133,0133,0133,0133,0133,0133,0133,0133,0133,0133,0142,0153,0141,0141,0141,0141,0146
0145,0141,0141,0141,0150,0149,0133,0133,0133,0133,0133,0133,0133,0133,0133,0133,0133,0142,0153,0141,0141,0141,0141,0141,0141,0146,0133,0133,0133,0133,0133,0133,0133,0133,0133,0133,0133,0133,0133,0133,0133,0133,0133,0133,0133,0133,0133,0133,0133,0133,0133,0133,0142,0153,0141,0141,0141,0141,0141,0146
0145,0141,0141,0141,0146,0133,0133,0133,0133,0133,0133,0133,0133,0133,0133,0133,0142,0153,0141,0141,0141,0141,0141,0141,0141,0152,0144,0133,0133,0133,0133,0133,0133,0133,0133,0133,0133,0133,0133,0133,0133,0133,0133,0133,0133,0133,0133,0133,0133,0133,0133,0142,0153,0141,0141,0141,0141,0141,0141,0146
0145,0141,0141,0141,0146,0133,0133,0133,0133,0133,0133,0133,0133,0133,0142,0143,0153,0141,0141,0141,0141,0141,0141,0141,0141,0141,0146,0133,0133,0133,0133,0133,0133,0133,0133,0133,0133,0133,0133,0133,0133,0133,0133,0133,0133,0133,0133,0133,0133,0133,0142,0153,0141,0141,0141,0141,0141,0141,0141,0146
0145,0141,0141,0141,0146,0133,0133,0133,0133,0133,0133,0133,0142,0143,0153,0141,0141,0141,0141,0141,0141,0141,0141,0141,0141,0141,0146,0133,0133,0133,0133,0133,0133,0133,0133,0133,0133,0133,0133,0133,0133,0133,0133,0133,0133,0133,0133,0133,0142,0143,0153,0141,0141,0141,0141,0141,0141,0141,0141,0146
0145,0141,0154,0141,0146,0133,0133,0133,0133,0133,0133,0142,0153,0141,0141,0141,0141,0141,0141,0141,0141,0141,0141,0141,0141,0141,0146,0133,0133,0133,0133,0133,0133,0133,0133,0133,0133,0133,0133,0133,0133,0133,0133,0133,0133,0133,0133,0142,0153,0141,0141,0141,0141,0141,0141,0141,0141,0141,0141,0146
0147,0148,0148,0148,0149,0133,0133,0133,0133,0133,0133,0145,0141,0141,0141,0141,0141,0141,0141,0141,0141,0141,0154,0141,0141,0141,0146,0133,0133,0133,0133,0133,0133,0133,0133,0133,0133,0133,0133,0133,0133,0133,0133,0133,0133,0142,0143,0153,0141,0141,0141,0141,0141,0141,0141,0141,0141,0141,0141,0146
0133,0133,0133,0133,0133,0133,0133,0133,0133,0133,0142,0153,0141,0141,0141,0141,0141,0141,0141,0141,0141,0141,0141,0141,0141,0150,0149,0133,0133,0133,0133,0133,0133,0133,0133,0133,0133,0133,0133,0133,0133,0133,0142,0143,0143,0153,0141,0141,0141,0141,0141,0141,0141,0141,0141,0141,0141,0141,0141,0146
0133,0133,0133,0133,0133,0133,0133,0133,0133,0133,0145,0141,0141,0141,0141,0141,0141,0141,0141,0141,0141,0141,0141,0141,0150,0149,0133,0133,0133,0133,0133,0133,0133,0133,0133,0133,0133,0133,0133,0133,0133,0133,0145,0141,0141,0141,0141,0141,0141,0141,0141,0141,0141,0141,0141,0141,0141,0141,0150,0149
0133,0133,0133,0133,0133,0133,0133,0133,0133,0133,0145,0141,0141,0141,0141,0141,0141,0141,0141,0141,0141,0141,0141,0141,0146,0133,0133,0133,0133,0133,0133,0133,0133,0133,0133,0133,0133,0133,0133,0133,0133,0133,0145,0141,0141,0141,0141,0141,0141,0141,0141,0141,0141,0141,0141,0141,0141,0141,0146,0133
0133,0133,0133,0133,0133,0133,0133,0133,0133,0142,0153,0141,0141,0141,0141,0141,0141,0141,0141,0141,0141,0141,0141,0150,0149,0133,0133,0133,0133,0133,0133,0133,0133,0133,0133,0133,0133,0133,0133,0133,0133,0133,0145,0141,0141,0141,0141,0141,0141,0141,0141,0141,0141,0141,0141,0141,0141,0141,0146,0133
0133,0133,0133,0133,0133,0133,0133,0133,0133,0145,0141,0141,0141,0141,0141,0141,0141,0141,0141,0141,0141,0141,0150,0149,0133,0133,0133,0133,0133,0133,0133,0133,0133,0133,0133,0133,0133,0133,0133,0133,0133,0133,0145,0141,0141,0141,0141,0141,0141,0141,0141,0141,0141,0141,0141,0141,0141,0141,0146,0133
0133,0133,0133,0133,0142,0143,0143,0143,0143,0153,0141,0141,0141,0141,0141,0141,0141,0141,0141,0141,0141,0150,0149,0133,0133,0133,0133,0133,0133,0133,0133,0133,0133,0133,0133,0133,0133,0133,0133,0133,0133,0142,0153,0141,0141,0141,0141,0141,0141,0141,0141,0141,0141,0141,0141,0141,0141,0141,0146,0133
0133,0133,0142,0143,0153,0141,0141,0141,0141,0141,0141,0141,0141,0141,0141,0141,0141,0141,0141,0141,0150,0149,0133,0133,0133,0133,0133,0133,0133,0133,0133,0133,0133,0133,0133,0133,0133,0133,0133,0133,0133,0145,0141,0141,0141,0141,0141,0141,0141,0141,0141,0141,0141,0141,0141,0141,0150,0148,0149,0133
0133,0133,0145,0141,0141,0141,0150,0148,0148,0148,0151,0141,0141,0141,0141,0141,0141,0141,0141,0150,0149,0133,0133,0133,0133,0133,0133,0133,0133,0133,0133,0133,0133,0133,0133,0133,0133,0133,0133,0133,0142,0153,0141,0141,0141,0141,0141,0141,0141,0141,0141,0141,0141,0141,0141,0141,0146,0142,0143,0144
0133,0133,0145,0141,0150,0148,0149,0133,0133,0133,0147,0151,0141,0141,0141,0141,0141,0141,0150,0149,0133,0133,0133,0133,0133,0133,0133,0133,0133,0133,0133,0133,0133,0133,0133,0133,0133,0133,0133,0133,0145,0141,0141,0141,0141,0141,0141,0141,0141,0141,0141,0141,0141,0141,0141,0150,0149,0145,0141,0146
0133,0142,0153,0141,0146,0133,0133,0133,0133,0133,0133,0147,0148,0148,0148,0148,0148,0148,0149,0133,0133,0133,0133,0133,0133,0133,0133,0133,0133,0133,0133,0133,0133,0133,0133,0133,0133,0133,0133,0133,0145,0141,0141,0141,0141,0141,0141,0141,0141,0141,0141,0141,0141,0141,0141,0146,0142,0153,0141,0146
0133,0145,0141,0141,0146,0133,0133,0133,0133,0133,0133,0133,0133,0133,0133,0133,0133,0133,0133,0133,0133,0133,0133,0133,0133,0133,0133,0133,0133,0133,0133,0133,0133,0133,0133,0133,0133,0133,0133,0133,0145,0141,0141,0141,0141,0141,0141,0141,0141,0141,0141,0141,0141,0141,0141,0146,0145,0141,0141,0146
0133,0145,0141,0150,0149,0133,0133,0133,0133,0133,0133,0133,0133,0133,0133,0133,0133,0133,0133,0133,0133,0133,0133,0133,0133,0133,0133,0133,0133,0133,0133,0133,0133,0133,0133,0133,0133,0133,0133,0142,0153,0141,0141,0141,0141,0141,0141,0141,0141,0141,0141,0141,0141,0141,0141,0152,0153,0141,0141,0146
0133,0145,0141,0146,0133,0133,0133,0133,0133,0133,0133,0133,0133,0133,0133,0133,0133,0133,0133,0133,0133,0133,0133,0133,0133,0133,0133,0133,0133,0133,0133,0133,0133,0133,0133,0133,0133,0133,0133,0145,0141,0141,0141,0141,0141,0141,0141,0141,0141,0141,0141,0141,0141,0141,0141,0141,0141,0141,0141,0146
0133,0145,0141,0146,0133,0142,0143,0143,0144,0133,0133,0133,0133,0133,0133,0133,0133,0133,0133,0133,0133,0133,0133,0133,0133,0133,0133,0133,0133,0133,0133,0133,0133,0133,0133,0133,0133,0133,0133,0145,0141,0141,0141,0141,0141,0141,0141,0141,0141,0141,0141,0141,0141,0141,0141,0141,0150,0148,0148,0149
0133,0145,0141,0152,0143,0153,0141,0141,0146,0133,0133,0133,0133,0133,0133,0133,0133,0133,0133,0133,0133,0133,0133,0133,0133,0133,0133,0133,0133,0133,0133,0133,0133,0133,0133,0133,0133,0133,0133,0145,0141,0141,0141,0141,0141,0141,0141,0141,0141,0141,0141,0141,0141,0141,0141,0150,0149,0133,0133,0133
0133,0145,0141,0141,0141,0141,0141,0141,0146,0133,0133,0133,0133,0133,0133,0133,0133,0133,0133,0133,0133,0133,0133,0133,0133,0133,0133,0133,0133,0133,0133,0133,0133,0133,0133,0133,0133,0133,0133,0145,0141,0141,0141,0141,0141,0141,0141,0141,0141,0141,0141,0141,0141,0141,0141,0146,0133,0133,0133,0133
0133,0147,0151,0141,0141,0141,0141,0141,0152,0144,0133,0133,0133,0133,0133,0133,0133,0133,0133,0133,0133,0133,0133,0133,0133,0133,0133,0133,0133,0133,0133,0133,0133,0133,0133,0133,0133,0133,0133,0145,0141,0141,0141,0141,0141,0141,0141,0141,0141,0141,0141,0141,0141,0141,0141,0152,0144,0133,0133,0133
0133,0133,0145,0141,0141,0141,0141,0141,0141,0152,0144,0133,0133,0133,0133,0133,0133,0133,0133,0133,0133,0133,0133,0133,0133,0133,0133,0133,0133,0133,0133,0133,0133,0133,0133,0133,0133,0133,0133,0145,0141,0141,0141,0141,0141,0141,0141,0141,0141,0141,0141,0141,0141,0141,0141,0141,0152,0144,0133,0133
0133,0133,0145,0141,0141,0141,0141,0141,0141,0141,0152,0144,0133,0133,0133,0133,0133,0133,0133,0133,0133,0133,0133,0133,0133,0133,0133,0133,0133,0133,0133,0133,0133,0133,0133,0133,0133,0133,0133,0145,0141,0141,0141,0141,0141,0141,0141,0141,0141,0141,0141,0141,0141,0141,0141,0141,0141,0146,0133,0133
0133,0142,0153,0141,0141,0141,0141,0141,0141,0141,0141,0152,0144,0133,0133,0133,0133,0133,0133,0133,0133,0133,0133,0133,0133,0133,0133,0133,0133,0133,0133,0133,0133,0133,0133,0133,0133,0133,0133,0145,0141,0141,0141,0141,0141,0141,0141,0141,0141,0141,0141,0141,0141,0141,0141,0141,0150,0149,0133,0133
0133,0145,0141,0141,0141,0141,0141,0141,0141,0141,0141,0141,0152,0143,0143,0143,0143,0143,0143,0143,0144,0133,0133,0133,0133,0133,0133,0133,0133,0133,0133,0133,0133,0133,0133,0133,0133,0133,0133,0145,0141,0141,0141,0141,0141,0141,0141,0141,0141,0141,0141,0141,0141,0141,0141,0141,0146,0133,0133,0133
0133,0145,0141,0141,0141,0141,0141,0141,0141,0141,0141,0141,0141,0141,0141,0141,0141,0141,0141,0141,0146,0133,0133,0133,0133,0133,0133,0133,0133,0133,0133,0133,0133,0133,0133,0133,0133,0133,0133,0147,0148,0151,0141,0141,0141,0141,0141,0141,0141,0141,0141,0141,0141,0141,0141,0141,0146,0133,0133,0133
0133,0147,0151,0141,0141,0141,0141,0141,0141,0141,0141,0141,0141,0141,0141,0141,0154,0141,0141,0150,0149,0133,0133,0133,0133,0133,0133,0133,0133,0133,0133,0133,0133,0133,0133,0133,0133,0133,0133,0133,0133,0147,0151,0141,0141,0141,0141,0141,0141,0141,0141,0141,0141,0141,0141,0141,0146,0133,0133,0133
0133,0133,0145,0141,0141,0141,0141,0141,0141,0141,0141,0141,0141,0141,0141,0141,0141,0141,0150,0149,0133,0133,0133,0133,0133,0133,0133,0133,0133,0133,0133,0133,0133,0133,0133,0133,0133,0133,0133,0133,0133,0133,0145,0141,0141,0141,0141,0141,0141,0141,0141,0141,0141,0141,0141,0141,0152,0144,0133,0133
0133,0133,0147,0151,0141,0141,0141,0141,0141,0141,0141,0141,0141,0141,0141,0141,0150,0148,0149,0133,0133,0133,0133,0133,0133,0133,0133,0133,0133,0133,0133,0133,0133,0133,0133,0133,0133,0133,0133,0133,0133,0133,0147,0151,0141,0141,0141,0141,0141,0141,0141,0141,0141,0141,0141,0141,0141,0146,0133,0133
0133,0133,0133,0147,0148,0148,0148,0148,0148,0148,0148,0148,0148,0148,0148,0148,0149,0133,0133,0133,0133,0133,0133,0133,0133,0133,0133,0133,0133,0133,0133,0133,0133,0133,0133,0133,0133,0133,0133,0133,0133,0133,0133,0145,0141,0141,0141,0141,0141,0141,0141,0141,0141,0141,0141,0141,0141,0152,0144,0133
0133,0133,0133,0133,0133,0133,0133,0133,0133,0133,0133,0133,0133,0133,0133,0133,0133,0133,0133,0133,0133,0133,0133,0133,0133,0133,0133,0133,0133,0133,0133,0133,0133,0133,0133,0133,0133,0133,0133,0133,0133,0133,0133,0147,0151,0141,0141,0141,0141,0141,0141,0141,0141,0141,0141,0141,0141,0141,0152,0144
0133,0133,0133,0133,0133,0133,0133,0133,0133,0133,0133,0133,0133,0133,0133,0133,0133,0133,0133,0133,0133,0133,0133,0133,0133,0133,0133,0133,0133,0133,0133,0133,0133,0133,0133,0133,0133,0133,0133,0133,0133,0133,0133,0133,0147,0151,0141,0141,0141,0141,0141,0141,0141,0141,0141,0141,0141,0141,0141,0146
0133,0133,0133,0133,0133,0133,0133,0133,0133,0133,0133,0133,0133,0133,0133,0133,0133,0133,0133,0133,0133,0133,0133,0133,0133,0133,0133,0133,0133,0133,0133,0133,0133,0133,0133,0133,0133,0133,0133,0133,0133,0133,0133,0133,0133,0145,0141,0141,0141,0141,0141,0141,0141,0141,0141,0141,0141,0141,0141,0146
0133,0133,0133,0133,0133,0133,0133,0133,0133,0133,0133,0133,0133,0133,0133,0133,0133,0133,0133,0133,0133,0133,0133,0133,0133,0133,0133,0133,0133,0133,0133,0133,0133,0133,0133,0133,0133,0133,0133,0133,0133,0133,0133,0133,0133,0147,0148,0151,0141,0141,0141,0141,0141,0141,0141,0141,0141,0141,0141,0146
0133,0133,0133,0133,0133,0133,0133,0133,0133,0133,0133,0133,0133,0133,0133,0133,0133,0133,0133,0133,0133,0133,0133,0133,0133,0133,0133,0133,0133,0133,0133,0133,0133,0133,0133,0133,0133,0133,0133,0133,0133,0133,0133,0133,0133,0133,0133,0147,0151,0141,0141,0141,0141,0141,0141,0141,0141,0141,0141,0146
0133,0133,0133,0133,0133,0133,0133,0133,0133,0133,0133,0133,0133,0133,0133,0133,0133,0133,0133,0133,0133,0133,0133,0133,0133,0133,0133,0133,0133,0133,0133,0133,0133,0133,0133,0133,0133,0133,0133,0133,0133,0133,0133,0133,0133,0133,0133,0133,0147,0151,0141,0141,0141,0141,0141,0141,0141,0141,0141,0146
0133,0133,0133,0133,0133,0133,0133,0133,0133,0133,0133,0133,0133,0133,0133,0133,0133,0133,0133,0133,0133,0133,0133,0133,0133,0133,0133,0133,0133,0133,0133,0133,0133,0133,0133,0133,0133,0133,0133,0133,0133,0133,0133,0133,0133,0133,0133,0133,0133,0147,0151,0141,0141,0141,0141,0141,0141,0141,0154,0146
0133,0133,0133,0133,0133,0133,0133,0133,0133,0133,0133,0133,0133,0133,0133,0133,0133,0133,0133,0133,0133,0133,0133,0133,0133,0133,0133,0133,0133,0133,0133,0133,0133,0133,0133,0133,0133,0133,0133,0133,0133,0133,0133,0133,0133,0133,0133,0133,0133,0133,0147,0148,0148,0148,0148,0148,0148,0148,0148,0149
0133,0133,0133,0133,0133,0133,0133,0133,0133,0133,0133,0133,0133,0133,0133,0133,0133,0133,0133,0133,0133,0133,0133,0133,0133,0133,0133,0133,0133,0133,0133,0133,0133,0133,0133,0133,0133,0133,0133,0133,0133,0133,0133,0133,0133,0133,0133,0133,0133,0133,0142,0143,0143,0143,0143,0143,0143,0143,0143,0143
0133,0133,0133,0133,0133,0133,0133,0133,0133,0133,0133,0133,0133,0133,0133,0133,0133,0133,0133,0133,0133,0133,0133,0133,0133,0133,0133,0133,0133,0133,0133,0133,0133,0133,0133,0133,0133,0133,0133,0133,0133,0133,0133,0133,0133,0133,0133,0133,0133,0133,0145,0154,0141,0141,0141,0141,0141,0141,0141,0141
0133,0133,0133,0133,0133,0133,0133,0133,0133,0133,0133,0133,0133,0133,0133,0133,0133,0133,0133,0133,0133,0133,0133,0133,0133,0133,0133,0133,0133,0133,0133,0133,0133,0133,0133,0133,0133,0133,0133,0133,0133,0133,0133,0133,0133,0133,0133,0133,0133,0133,0147,0148,0148,0148,0148,0148,0148,0148,0148,0148