inside:false
objects:none
warps:2,21,pie_cavern_top,2,21|12,8,pie_cavern_top,12,8|16,45,pie_cavern_top,16,45|22,2,pie_cavern_top,22,2|51,58,pie_cavern_top,51,58|58,55,pie_cavern_top,58,55|45,2,pie_cavern_top,45,2|45,11,pie_cavern_top,45,11|22,22,pie_cavern_top,22,22
connections:none
wild:none
conditions:
configuration:
0133,0133,0133,0133,0133,0133,0133,0133,0133,0133,0133,0133,0133,0133,0133,0133,0133,0133,0133,0133,0133,0133,0133,0133,0133,0133,0133,0133,0133,0133,0133,0133,0133,0133,0142,0143,0143,0143,0143,0143,0143,0143,0143,0143,0143,0144,0133,0133,0133,0133,0133,0133,0133,0133,0133,0133,0133,0133,0133,0133
0133,0133,0133,0133,0133,0133,0133,0133,0133,0133,0133,0133,0133,0133,0133,0133,0133,0133,0133,0133,0133,0142,0143,0144,0133,0133,0133,0133,0133,0133,0133,0133,0142,0143,0153,0141,0141,0141,0141,0141,0141,0141,0141,0141,0141,0152,0144,0133,0133,0133,0133,0133,0133,0133,0133,0133,0133,0133,0133,0133
0133,0133,0133,0133,0133,0133,0133,0133,0133,0133,0133,0133,0133,0133,0133,0133,0133,0133,0133,0133,0133,0145,0154,0146,0133,0133,0133,0133,0133,0133,0133,0133,0145,0141,0141,0141,0150,0148,0148,0148,0148,0148,0148,0151,0141,0154,0146,0133,0133,0133,0133,0133,0133,0133,0133,0133,0133,0133,0133,0133
0133,0133,0133,0133,0133,0133,0133,0133,0133,0133,0133,0133,0133,0133,0133,0133,0133,0133,0133,0133,0133,0145,0141,0146,0133,0133,0133,0133,0133,0133,0133,0133,0145,0141,0150,0148,0149,0133,0133,0133,0133,0133,0133,0133,0148,0148,0149,0133,0133,0133,0133,0133,0133,0133,0133,0133,0133,0133,0133,0133
0133,0133,0133,0133,0133,0133,0133,0133,0133,0133,0133,0133,0133,0133,0133,0133,0133,0133,0133,0133,0133,0145,0141,0146,0133,0133,0133,0133,0133,0133,0133,0133,0145,0141,0146,0133,0133,0133,0133,0133,0133,0133,0133,0133,0133,0133,0133,0133,0133,0133,0133,0133,0133,0133,0133,0133,0133,0133,0133,0133
0133,0133,0133,0133,0133,0133,0133,0133,0133,0133,0133,0133,0133,0133,0133,0133,0133,0133,0133,0133,0142,0153,0141,0146,0133,0133,0133,0133,0133,0133,0133,0133,0145,0141,0152,0144,0133,0133,0133,0133,0133,0133,0133,0133,0133,0133,0133,0133,0133,0133,0133,0133,0133,0133,0133,0133,0133,0133,0133,0133
0133,0133,0133,0133,0133,0133,0133,0133,0133,0133,0133,0133,0133,0133,0133,0133,0133,0133,0133,0133,0145,0141,0141,0146,0133,0133,0133,0133,0133,0133,0133,0133,0145,0141,0141,0152,0143,0144,0133,0133,0133,0133,0133,0133,0133,0133,0133,0133,0133,0133,0133,0133,0133,0133,0133,0133,0133,0133,0133,0133
0133,0133,0133,0133,0133,0133,0133,0133,0133,0133,0133,0142,0143,0144,0133,0133,0133,0133,0133,0133,0145,0141,0150,0149,0133,0133,0133,0133,0133,0133,0133,0133,0147,0151,0141,0141,0141,0152,0143,0143,0144,0133,0133,0133,0133,0133,0133,0133,0133,0133,0133,0133,0133,0133,0133,0133,0133,0133,0133,0133
0133,0133,0133,0133,0133,0133,0133,0133,0133,0133,0133,0145,0154,0146,0133,0133,0133,0133,0133,0133,0145,0141,0146,0133,0133,0133,0133,0133,0133,0133,0133,0133,0133,0147,0148,0151,0141,0141,0141,0141,0152,0143,0143,0143,0144,0133,0133,0133,0133,0133,0133,0133,0133,0133,0133,0133,0133,0133,0133,0133
0133,0133,0133,0133,0133,0133,0133,0133,0133,0133,0133,0145,0141,0146,0133,0133,0133,0133,0133,0133,0145,0141,0146,0133,0133,0133,0133,0133,0133,0133,0133,0133,0133,0133,0133,0147,0148,0148,0151,0141,0141,0141,0141,0141,0152,0144,0133,0133,0133,0133,0133,0133,0133,0133,0133,0133,0133,0133,0133,0133
0133,0133,0133,0133,0133,0133,0133,0133,0133,0133,0133,0145,0141,0146,0133,0133,0133,0133,0133,0133,0145,0141,0146,0133,0133,0133,0133,0133,0133,0133,0133,0133,0133,0133,0133,0133,0133,0133,0147,0148,0148,0151,0141,0141,0141,0152,0144,0133,0133,0133,0133,0133,0133,0133,0133,0133,0133,0133,0133,0133
0133,0133,0133,0133,0133,0133,0133,0133,0133,0133,0133,0145,0141,0146,0133,0133,0133,0133,0133,0142,0153,0141,0146,0133,0133,0133,0133,0133,0133,0133,0133,0133,0133,0133,0133,0133,0133,0133,0133,0133,0133,0147,0148,0151,0141,0154,0146,0133,0133,0133,0133,0133,0133,0133,0133,0133,0133,0133,0133,0133
0133,0133,0133,0133,0133,0133,0133,0133,0133,0133,0133,0145,0141,0146,0133,0133,0133,0133,0142,0153,0141,0141,0146,0133,0133,0133,0133,0133,0133,0133,0133,0133,0133,0133,0133,0133,0133,0133,0133,0133,0133,0133,0133,0147,0148,0148,0149,0133,0133,0133,0133,0133,0133,0133,0133,0133,0133,0133,0133,0133
0133,0133,0133,0133,0133,0133,0133,0133,0133,0133,0133,0145,0141,0146,0142,0143,0143,0143,0153,0141,0141,0150,0149,0133,0133,0133,0133,0133,0133,0133,0133,0133,0133,0133,0133,0133,0133,0133,0133,0133,0133,0133,0133,0133,0133,0133,0133,0133,0133,0133,0133,0133,0133,0133,0133,0133,0133,0133,0133,0133
0133,0133,0133,0133,0133,0133,0133,0133,0133,0133,0142,0153,0141,0152,0153,0141,0141,0141,0141,0141,0150,0149,0133,0133,0133,0133,0133,0133,0133,0133,0133,0133,0133,0133,0133,0133,0133,0133,0133,0133,0133,0133,0133,0133,0133,0133,0133,0133,0133,0133,0133,0133,0133,0133,0133,0133,0133,0133,0133,0133
0133,0133,0133,0133,0133,0133,0133,0133,0133,0133,0145,0141,0141,0141,0141,0141,0141,0141,0150,0148,0149,0133,0133,0133,0133,0133,0133,0133,0133,0133,0133,0133,0133,0133,0133,0133,0133,0133,0133,0133,0133,0133,0133,0133,0133,0133,0133,0133,0133,0133,0133,0133,0133,0133,0133,0133,0133,0133,0133,0133
0133,0133,0133,0133,0133,0133,0133,0133,0133,0133,0145,0141,0150,0148,0148,0148,0148,0148,0149,0133,0133,0133,0133,0133,0133,0133,0133,0133,0133,0133,0133,0133,0133,0133,0133,0133,0133,0133,0133,0133,0133,0133,0133,0133,0133,0133,0133,0133,0133,0133,0133,0133,0133,0133,0133,0133,0133,0133,0133,0133
0133,0133,0133,0133,0133,0133,0133,0133,0133,0142,0153,0141,0146,0133,0133,0133,0133,0133,0133,0133,0133,0133,0133,0133,0133,0133,0133,0133,0133,0133,0133,0133,0133,0133,0133,0133,0133,0133,0133,0133,0133,0133,0133,0133,0133,0133,0133,0133,0133,0133,0133,0133,0133,0133,0133,0133,0133,0133,0133,0133
0133,0133,0133,0133,0142,0143,0143,0143,0143,0153,0141,0141,0146,0133,0133,0133,0133,0133,0133,0133,0133,0133,0133,0133,0133,0133,0133,0133,0133,0133,0133,0133,0133,0133,0133,0133,0133,0133,0133,0133,0133,0133,0133,0133,0133,0133,0133,0133,0133,0133,0133,0133,0133,0133,0133,0133,0133,0133,0133,0133
0133,0133,0133,0142,0153,0141,0141,0141,0141,0141,0141,0150,0149,0133,0133,0133,0133,0133,0133,0133,0133,0133,0142,0143,0143,0143,0144,0133,0133,0133,0133,0133,0133,0133,0133,0133,0133,0133,0133,0133,0133,0133,0133,0133,0133,0133,0133,0133,0133,0133,0133,0133,0133,0133,0133,0133,0133,0133,0133,0133
0133,0142,0143,0153,0141,0141,0150,0148,0148,0148,0148,0149,0133,0133,0133,0133,0133,0133,0133,0133,0133,0142,0153,0141,0141,0141,0152,0143,0143,0143,0143,0143,0143,0143,0143,0143,0144,0133,0133,0133,0133,0133,0133,0133,0133,0133,0133,0133,0133,0133,0133,0133,0133,0133,0133,0133,0133,0133,0133,0133
0133,0145,0154,0141,0141,0150,0149,0133,0133,0133,0133,0133,0133,0133,0133,0133,0133,0133,0133,0133,0133,0145,0141,0141,0141,0141,0141,0141,0141,0141,0141,0141,0141,0141,0141,0141,0152,0144,0133,0133,0133,0133,0133,0133,0133,0133,0133,0133,0133,0133,0133,0133,0133,0133,0133,0133,0133,0133,0133,0133
0133,0147,0148,0148,0148,0149,0133,0133,0133,0133,0133,0133,0133,0133,0133,0133,0133,0133,0133,0133,0133,0145,0154,0141,0141,0141,0141,0141,0141,0141,0141,0141,0141,0141,0141,0141,0141,0146,0133,0133,0133,0133,0133,0133,0133,0133,0133,0133,0133,0133,0133,0133,0133,0133,0133,0133,0133,0133,0133,0133
0133,0133,0133,0133,0133,0133,0133,0133,0133,0133,0133,0133,0133,0133,0133,0133,0133,0133,0133,0133,0133,0145,0141,0141,0141,0141,0141,0141,0141,0141,0141,0141,0141,0141,0141,0141,0141,0152,0143,0144,0133,0133,0133,0133,0133,0133,0133,0133,0133,0133,0133,0133,0133,0133,0133,0133,0133,0133,0133,0133
0133,0133,0133,0133,0133,0133,0133,0133,0133,0133,0133,0133,0133,0133,0133,0133,0133,0133,0133,0133,0133,0147,0148,0151,0141,0141,0141,0141,0141,0141,0141,0141,0141,0141,0141,0141,0141,0141,0141,0152,0144,0133,0133,0133,0133,0133,0133,0133,0133,0133,0133,0133,0133,0133,0133,0133,0133,0133,0133,0133
0133,0133,0133,0133,0133,0133,0133,0133,0133,0133,0133,0133,0133,0133,0133,0133,0133,0133,0133,0133,0133,0133,0133,0133,0148,0148,0148,0148,0148,0148,0151,0141,0141,0141,0141,0141,0141,0141,0141,0141,0152,0144,0133,0133,0133,0133,0133,0133,0133,0133,0133,0133,0133,0133,0133,0133,0133,0133,0133,0133
0133,0133,0133,0133,0133,0133,0133,0133,0133,0133,0133,0133,0133,0133,0133,0133,0133,0133,0133,0133,0133,0133,0133,0133,0133,0133,0133,0133,0133,0133,0145,0141,0150,0148,0148,0151,0141,0141,0141,0141,0141,0146,0133,0133,0133,0133,0133,0133,0133,0133,0133,0133,0133,0133,0133,0133,0133,0133,0133,0133
0133,0133,0133,0133,0133,0133,0133,0133,0133,0133,0133,0133,0133,0133,0133,0133,0133,0133,0133,0133,0133,0133,0133,0133,0133,0133,0133,0133,0133,0133,0145,0141,0146,0133,0133,0147,0151,0141,0141,0141,0141,0152,0144,0133,0133,0133,0133,0133,0133,0133,0133,0133,0133,0133,0133,0133,0133,0133,0133,0133
0133,0133,0133,0133,0133,0133,0133,0133,0133,0133,0133,0133,0133,0133,0133,0133,0133,0133,0133,0133,0133,0133,0133,0133,0133,0133,0133,0133,0133,0133,0145,0141,0146,0133,0133,0133,0145,0141,0141,0141,0141,0141,0152,0144,0133,0133,0133,0133,0133,0133,0133,0133,0133,0133,0133,0133,0133,0133,0133,0133
0133,0133,0133,0133,0133,0133,0133,0133,0133,0133,0133,0133,0133,0133,0133,0133,0133,0133,0133,0133,0133,0133,0133,0133,0133,0133,0133,0133,0133,0133,0145,0141,0146,0133,0133,0133,0147,0151,0141,0141,0141,0141,0141,0146,0133,0133,0133,0133,0133,0133,0133,0133,0133,0133,0133,0133,0133,0133,0133,0133
0133,0133,0133,0133,0133,0133,0133,0133,0133,0133,0133,0133,0133,0133,0133,0133,0133,0133,0133,0133,0133,0133,0133,0133,0133,0133,0133,0133,0133,0133,0145,0141,0146,0133,0133,0133,0133,0145,0141,0141,0141,0141,0141,0152,0144,0133,0133,0133,0133,0133,0133,0133,0133,0133,0133,0133,0133,0133,0133,0133
0133,0133,0133,0133,0133,0133,0133,0133,0133,0133,0133,0133,0133,0133,0133,0133,0133,0133,0133,0133,0133,0133,0133,0133,0133,0133,0133,0133,0133,0133,0145,0141,0146,0133,0133,0133,0133,0147,0148,0151,0141,0141,0141,0141,0152,0144,0133,0133,0133,0133,0133,0133,0133,0133,0133,0133,0133,0133,0133,0133
0133,0133,0133,0133,0133,0133,0133,0133,0133,0133,0133,0133,0133,0133,0133,0133,0133,0133,0133,0133,0133,0133,0133,0133,0133,0133,0133,0133,0133,0133,0145,0141,0146,0133,0133,0133,0133,0133,0133,0145,0141,0141,0141,0141,0141,0146,0133,0133,0133,0133,0133,0133,0133,0133,0133,0133,0133,0133,0133,0133
0133,0133,0133,0133,0133,0133,0133,0133,0133,0133,0133,0133,0133,0133,0133,0133,0133,0133,0133,0133,0133,0133,0133,0133,0133,0133,0133,0133,0133,0133,0145,0141,0146,0133,0133,0133,0133,0133,0133,0145,0141,0141,0141,0141,0141,0152,0144,0133,0133,0133,0133,0133,0133,0133,0133,0133,0133,0133,0133,0133
0133,0133,0133,0133,0133,0133,0133,0133,0133,0133,0133,0133,0133,0133,0133,0133,0133,0133,0133,0133,0133,0133,0133,0133,0133,0133,0133,0142,0143,0144,0145,0141,0146,0133,0133,0133,0133,0133,0133,0145,0141,0141,0141,0141,0141,0141,0146,0133,0133,0133,0133,0133,0133,0133,0133,0133,0133,0133,0133,0133
0133,0133,0133,0133,0133,0133,0133,0133,0133,0133,0133,0133,0133,0133,0133,0133,0133,0133,0133,0133,0133,0133,0133,0133,0133,0133,0133,0145,0141,0146,0145,0141,0146,0133,0133,0133,0133,0133,0133,0147,0151,0141,0141,0141,0141,0141,0146,0133,0133,0133,0133,0133,0133,0133,0133,0133,0133,0133,0133,0133
0133,0133,0133,0133,0133,0133,0133,0133,0133,0133,0133,0133,0133,0133,0133,0133,0133,0133,0133,0133,0133,0133,0133,0133,0133,0133,0133,0145,0141,0146,0147,0148,0149,0133,0133,0133,0133,0133,0133,0133,0147,0151,0141,0141,0141,0141,0152,0144,0133,0133,0133,0133,0133,0133,0133,0133,0133,0133,0133,0133
0133,0133,0133,0133,0133,0133,0133,0133,0133,0133,0133,0133,0133,0133,0133,0133,0133,0133,0133,0133,0133,0133,0133,0133,0142,0143,0144,0145,0141,0146,0133,0133,0133,0133,0133,0133,0133,0133,0133,0133,0133,0145,0141,0141,0141,0141,0141,0152,0144,0133,0133,0133,0133,0133,0133,0133,0133,0133,0133,0133
0133,0133,0133,0133,0133,0133,0133,0133,0133,0133,0133,0133,0133,0133,0133,0133,0133,0133,0133,0133,0133,0133,0133,0133,0145,0141,0146,0145,0141,0146,0133,0133,0133,0133,0133,0133,0133,0133,0133,0133,0133,0147,0151,0141,0141,0141,0141,0141,0146,0133,0133,0133,0133,0133,0133,0133,0133,0133,0133,0133
0133,0133,0133,0133,0133,0133,0133,0133,0133,0133,0133,0133,0133,0133,0133,0133,0133,0133,0133,0133,0133,0133,0133,0133,0145,0141,0146,0145,0141,0146,0133,0133,0133,0133,0133,0133,0133,0133,0133,0133,0133,0133,0145,0141,0141,0141,0141,0141,0152,0144,0133,0133,0133,0133,0133,0133,0133,0133,0133,0133
0133,0133,0133,0133,0133,0133,0133,0133,0133,0133,0133,0133,0133,0133,0133,0133,0133,0133,0133,0133,0133,0133,0133,0133,0145,0141,0146,0145,0141,0146,0133,0133,0133,0133,0133,0133,0133,0133,0133,0133,0133,0133,0147,0151,0141,0141,0141,0141,0141,0146,0133,0133,0133,0133,0133,0133,0133,0133,0133,0133
0133,0133,0133,0133,0133,0133,0133,0133,0133,0133,0133,0133,0133,0133,0133,0133,0133,0133,0133,0133,0133,0133,0133,0133,0145,0141,0146,0145,0141,0146,0133,0133,0133,0133,0133,0133,0133,0133,0133,0133,0133,0133,0133,0145,0141,0141,0141,0141,0141,0152,0144,0133,0133,0133,0133,0133,0133,0133,0133,0133
0133,0133,0133,0133,0133,0133,0133,0133,0133,0133,0133,0142,0143,0143,0144,0133,0133,0133,0133,0133,0133,0133,0133,0133,0145,0141,0146,0145,0141,0146,0133,0133,0133,0133,0133,0133,0133,0133,0133,0133,0133,0133,0133,0147,0151,0141,0141,0141,0141,0141,0152,0143,0144,0133,0133,0133,0133,0133,0133,0133
0133,0133,0133,0133,0133,0133,0133,0133,0133,0142,0143,0153,0141,0141,0152,0143,0144,0133,0133,0133,0133,0133,0133,0133,0145,0141,0146,0145,0141,0146,0133,0133,0133,0133,0133,0133,0133,0133,0133,0133,0133,0133,0133,0133,0147,0151,0141,0141,0141,0141,0141,0141,0152,0144,0133,0133,0133,0133,0133,0133
0133,0133,0133,0133,0133,0133,0133,0133,0142,0153,0141,0141,0141,0141,0141,0141,0152,0143,0144,0133,0133,0133,0133,0133,0145,0141,0146,0145,0141,0146,0133,0133,0133,0133,0133,0133,0133,0133,0133,0133,0133,0133,0133,0133,0133,0147,0151,0141,0141,0141,0141,0141,0141,0146,0133,0133,0133,0133,0133,0133
0133,0133,0133,0133,0133,0133,0133,0133,0145,0141,0141,0141,0141,0141,0141,0141,0154,0141,0152,0133,0133,0133,0133,0133,0145,0141,0146,0145,0141,0146,0133,0133,0133,0133,0133,0133,0133,0133,0133,0133,0133,0133,0133,0133,0133,0133,0145,0141,0141,0141,0141,0141,0141,0146,0133,0133,0133,0133,0133,0133
0133,0133,0133,0133,0133,0133,0133,0142,0153,0141,0141,0141,0141,0141,0141,0141,0141,0141,0141,0152,0143,0144,0133,0133,0145,0141,0146,0145,0141,0146,0133,0133,0133,0133,0133,0133,0133,0133,0133,0133,0133,0133,0133,0133,0133,0133,0147,0151,0141,0141,0141,0141,0141,0146,0133,0133,0133,0133,0133,0133
0133,0133,0133,0133,0133,0133,0142,0153,0141,0141,0141,0141,0141,0141,0141,0141,0141,0141,0141,0141,0141,0152,0143,0143,0153,0141,0146,0145,0141,0146,0133,0133,0133,0133,0133,0133,0133,0133,0133,0133,0133,0133,0133,0133,0133,0133,0133,0145,0141,0141,0141,0141,0141,0152,0144,0133,0133,0133,0133,0133
0133,0133,0133,0133,0133,0133,0145,0141,0141,0141,0141,0141,0141,0141,0141,0141,0141,0141,0141,0141,0141,0141,0141,0141,0141,0141,0146,0145,0141,0146,0133,0133,0133,0133,0133,0133,0133,0133,0133,0133,0133,0133,0133,0133,0133,0133,0133,0145,0141,0141,0141,0141,0141,0141,0152,0144,0133,0133,0133,0133
0133,0133,0133,0133,0133,0133,0145,0141,0141,0141,0141,0141,0141,0141,0141,0141,0141,0141,0141,0141,0141,0141,0141,0141,0141,0141,0152,0153,0141,0146,0133,0133,0133,0133,0133,0133,0133,0133,0133,0133,0133,0133,0133,0133,0133,0133,0133,0145,0141,0141,0141,0141,0141,0141,0141,0146,0133,0133,0133,0133
0133,0133,0133,0133,0133,0133,0147,0151,0141,0141,0141,0141,0141,0141,0110,0111,0111,0112,0141,0141,0141,0141,0141,0141,0141,0141,0141,0141,0141,0146,0133,0133,0133,0133,0133,0133,0133,0133,0133,0133,0133,0133,0133,0133,0133,0133,0133,0147,0151,0141,0141,0141,0141,0141,0141,0152,0143,0144,0133,0133
0133,0133,0133,0133,0133,0133,0133,0145,0141,0141,0141,0141,0141,0141,0113,0005,0005,0114,0141,0141,0141,0141,0141,0141,0141,0141,0141,0141,0141,0146,0133,0133,0133,0133,0133,0133,0133,0133,0133,0133,0133,0133,0133,0133,0133,0133,0133,0133,0147,0148,0151,0141,0141,0141,0141,0141,0141,0152,0143,0144
0133,0133,0133,0133,0133,0133,0133,0145,0141,0141,0141,0141,0141,0141,0115,0116,0116,0117,0141,0141,0141,0141,0141,0141,0141,0141,0141,0141,0141,0146,0133,0133,0133,0133,0133,0133,0133,0133,0133,0133,0133,0133,0133,0133,0133,0133,0133,0133,0133,0133,0147,0148,0151,0141,0141,0141,0141,0141,0141,0146
0133,0133,0133,0133,0133,0133,0133,0145,0141,0141,0141,0141,0141,0141,0141,0141,0141,0141,0141,0141,0141,0141,0141,0141,0141,0141,0141,0141,0141,0146,0133,0133,0133,0133,0133,0133,0133,0133,0133,0133,0133,0133,0133,0133,0133,0133,0133,0133,0133,0133,0133,0133,0147,0148,0151,0141,0141,0141,0141,0146
0133,0133,0133,0133,0133,0133,0133,0145,0141,0141,0141,0141,0141,0141,0141,0141,0141,0141,0141,0141,0141,0141,0141,0141,0141,0141,0141,0141,0141,0146,0133,0133,0133,0133,0133,0133,0133,0133,0133,0133,0133,0133,0133,0133,0133,0133,0133,0133,0133,0133,0133,0133,0133,0133,0147,0148,0151,0141,0141,0146
0133,0133,0133,0133,0133,0133,0133,0147,0151,0141,0141,0141,0141,0141,0141,0141,0141,0141,0141,0141,0141,0141,0141,0141,0141,0141,0141,0141,0141,0146,0133,0133,0133,0133,0133,0133,0133,0133,0133,0133,0133,0133,0133,0133,0133,0133,0133,0133,0133,0133,0133,0133,0133,0133,0133,0133,0147,0151,0154,0146
0133,0133,0133,0133,0133,0133,0133,0133,0147,0148,0151,0141,0141,0141,0141,0141,0141,0141,0141,0141,0141,0141,0141,0141,0141,0141,0141,0141,0150,0149,0133,0133,0133,0133,0133,0133,0133,0133,0133,0133,0133,0133,0133,0133,0133,0133,0133,0133,0133,0133,0133,0133,0133,0133,0133,0133,0133,0147,0148,0149
0133,0133,0133,0133,0133,0133,0133,0133,0133,0133,0147,0151,0141,0141,0141,0141,0141,0141,0141,0141,0141,0141,0141,0141,0141,0141,0141,0141,0152,0143,0143,0143,0143,0143,0143,0143,0143,0143,0143,0143,0143,0143,0143,0143,0143,0143,0143,0143,0143,0143,0143,0143,0144,0133,0133,0133,0133,0133,0133,0133
0133,0133,0133,0133,0133,0133,0133,0133,0133,0133,0133,0147,0148,0151,0141,0141,0141,0141,0141,0141,0141,0141,0141,0141,0141,0141,0141,0141,0141,0141,0141,0141,0141,0141,0141,0141,0141,0141,0141,0141,0141,0141,0141,0141,0141,0141,0141,0141,0141,0141,0141,0154,0146,0133,0133,0133,0133,0133,0133,0133
0133,0133,0133,0133,0133,0133,0133,0133,0133,0133,0133,0133,0133,0147,0148,0148,0148,0148,0148,0148,0148,0148,0148,0148,0148,0148,0148,0148,0148,0148,0148,0148,0148,0148,0148,0148,0148,0148,0148,0148,0148,0148,0148,0148,0148,0148,0148,0148,0148,0148,0148,0148,0149,0133,0133,0133,0133,0133,0133,0133