inside:true
objects:trainer,7,5,west.oldman.Neil.2-1-none-none.3-1-none-none|item,2,8,0.pokeball
warps:8,9,player_house,8,8
connections:none
wild:grass,5,5,1
conditions:none|none
configuration:
0002,0002,0002,0002,0002,0002,0002,0002,0002,0002
0002,0001,0001,0001,0001,0003,0003,0003,0003,0002
0002,0001,0001,0001,0001,0003,0003,0003,0003,0002
0002,0001,0001,0001,0001,0001,0001,0001,0003,0002
0002,0001,0001,0001,0001,0001,0001,0001,0001,0002
0002,0001,0001,0001,0001,0001,0001,0001,0001,0002
0002,0001,0001,0001,0001,0001,0001,0001,0001,0002
0002,0001,0001,0001,0001,0001,0001,0001,0001,0002
0002,0001,0001,0001,0001,0001,0001,0001,0001,0002
0002,0001,0001,0001,0001,0001,0001,0001,0001,0002