inside:true
objects:none
warps:8,8,player_room,8,9|4,9,mar_a_lago,6,9
connections:none
wild:none
conditions:none|none
configuration:
0133,0132,0132,0132,0132,0132,0132,0132,0132,0133
0133,0130,0130,0130,0130,0130,0130,0130,0130,0133
0133,0130,0130,0130,0130,0130,0130,0130,0130,0133
0133,0130,0130,0130,0130,0130,0130,0130,0130,0133
0133,0130,0130,0130,0130,0130,0130,0130,0130,0133
0133,0130,0130,0130,0130,0130,0130,0130,0130,0133
0133,0130,0130,0130,0130,0130,0130,0130,0130,0133
0133,0130,0130,0130,0130,0130,0130,0130,0130,0133
0133,0130,0130,0130,0130,0130,0130,0130,0131,0133
0133,0133,0133,0133,0130,0133,0133,0133,0133,0133