inside:false
objects:none
warps:7,43,route_2_gate,4,0
connections:north,okeechobee,3
wild:none
conditions:
configuration:
0134,0134,0134,0134,0134,0005,0005,0005,0005,0134,0134,0134,0134,0134,0134
0136,0136,0136,0135,0136,0005,0005,0005,0005,0136,0135,0135,0136,0136,0136
0134,0134,0134,0136,0005,0005,0005,0005,0005,0005,0136,0136,0134,0134,0134
0135,0135,0136,0005,0005,0005,0005,0005,0005,0005,0005,0005,0136,0136,0136
0136,0136,0005,0005,0005,0005,0005,0005,0005,0005,0005,0005,0005,0005,0134
0134,0005,0005,0005,0005,0005,0005,0005,0005,0005,0005,0005,0005,0005,0136
0136,0005,0005,0005,0005,0005,0005,0005,0005,0005,0005,0005,0005,0005,0134
0134,0134,0134,0005,0005,0005,0005,0005,0005,0005,0005,0005,0005,0005,0136
0136,0136,0136,0134,0005,0005,0005,0005,0005,0005,0005,0005,0005,0005,0134
0134,0005,0136,0135,0134,0134,0005,0005,0005,0005,0005,0005,0005,0005,0136
0136,0005,0005,0136,0136,0135,0134,0134,0134,0134,0134,0005,0005,0005,0134
0134,0005,0005,0005,0005,0136,0136,0136,0136,0136,0135,0134,0005,0005,0136
0136,0005,0005,0005,0005,0005,0005,0005,0005,0005,0136,0136,0005,0005,0134
0134,0005,0005,0005,0005,0005,0005,0005,0005,0005,0005,0134,0005,0005,0136
0136,0005,0005,0005,0005,0005,0005,0005,0005,0005,0005,0136,0005,0005,0134
0134,0005,0005,0005,0005,0005,0005,0005,0005,0005,0005,0134,0005,0005,0136
0136,0005,0005,0005,0005,0005,0005,0005,0005,0134,0134,0135,0005,0005,0134
0134,0005,0005,0005,0005,0005,0005,0134,0134,0135,0136,0136,0005,0005,0136
0136,0005,0005,0005,0134,0134,0134,0135,0136,0136,0005,0005,0005,0005,0134
0134,0005,0005,0134,0135,0136,0136,0136,0005,0005,0005,0005,0005,0005,0136
0136,0080,0080,0136,0136,0005,0005,0005,0005,0005,0005,0005,0005,0005,0134
0134,0080,0080,0134,0005,0005,0005,0005,0005,0005,0005,0005,0005,0005,0136
0136,0080,0080,0136,0005,0005,0005,0005,0005,0005,0005,0005,0005,0005,0134
0134,0080,0080,0134,0005,0005,0005,0005,0005,0005,0005,0005,0005,0005,0136
0136,0080,0080,0136,0134,0005,0005,0005,0005,0005,0005,0005,0005,0005,0134
0134,0080,0080,0005,0135,0134,0005,0005,0005,0005,0005,0005,0005,0005,0136
0136,0080,0080,0005,0136,0135,0134,0134,0005,0005,0005,0005,0005,0005,0134
0134,0080,0080,0080,0080,0136,0136,0135,0134,0134,0005,0005,0005,0005,0136
0136,0080,0080,0080,0080,0080,0005,0136,0136,0135,0134,0005,0005,0005,0134
0134,0080,0080,0080,0080,0080,0005,0005,0005,0136,0135,0134,0005,0005,0136
0136,0080,0080,0080,0080,0080,0005,0005,0005,0005,0136,0136,0005,0005,0134
0134,0080,0080,0080,0080,0080,0080,0080,0080,0080,0080,0134,0005,0005,0136
0136,0080,0080,0080,0080,0080,0080,0080,0080,0080,0080,0136,0005,0005,0134
0134,0080,0080,0080,0080,0080,0080,0080,0080,0080,0080,0134,0005,0005,0136
0136,0080,0080,0080,0080,0080,0080,0080,0080,0080,0080,0136,0005,0005,0134
0134,0080,0080,0080,0080,0080,0080,0080,0080,0080,0080,0134,0005,0005,0136
0136,0080,0080,0080,0080,0080,0080,0080,0134,0134,0134,0136,0005,0005,0134
0134,0080,0080,0080,0080,0080,0134,0134,0136,0136,0136,0005,0005,0005,0136
0136,0095,0095,0095,0095,0095,0136,0136,0005,0005,0005,0005,0005,0005,0134
0134,0005,0005,0005,0005,0005,0005,0005,0005,0005,0005,0005,0005,0005,0136
0136,0005,0005,0005,0005,0005,0005,0005,0005,0005,0005,0005,0005,0005,0134
0134,0005,0005,0005,0005,0005,0005,0005,0005,0005,0005,0005,0005,0005,0136
0136,0005,0005,0005,0005,0005,0005,0005,0005,0005,0005,0005,0005,0005,0134
0134,0005,0005,0005,0005,0140,0140,0130,0140,0140,0005,0005,0005,0005,0135
0136,0005,0005,0005,0005,0138,0138,0138,0138,0138,0005,0005,0005,0005,0136