inside:false
objects:none
warps:4,9,route_1,5,2|4,0,unown_city,22,44
connections:none
wild:none
conditions:
configuration:
0133,0132,0132,0132,0130,0132,0132,0132,0132,0133
0133,0130,0130,0130,0130,0130,0130,0130,0130,0133
0133,0130,0130,0130,0130,0130,0130,0130,0130,0133
0133,0130,0130,0130,0130,0130,0130,0130,0130,0133
0133,0130,0130,0130,0130,0130,0130,0130,0130,0133
0133,0130,0130,0130,0130,0130,0130,0130,0130,0133
0133,0130,0130,0130,0130,0130,0130,0130,0130,0133
0133,0130,0130,0130,0130,0130,0130,0130,0130,0133
0133,0130,0130,0130,0130,0130,0130,0130,0130,0133
0133,0133,0133,0133,0130,0133,0133,0133,0133,0133