inside:false
objects:none
warps:22,5,pie_cavern_top,0,1
connections:west,okeechobee,0
wild:none
conditions:
configuration:
0134,0134,0134,0134,0134,0134,0134,0134,0134,0134,0134,0134,0134,0134,0134,0134,0134,0134,0134,0134,0134,0134,0134,0134,0134
0136,0136,0136,0136,0136,0136,0136,0136,0136,0136,0136,0136,0136,0136,0136,0136,0136,0136,0136,0136,0136,0135,0135,0135,0135
0005,0005,0005,0005,0005,0005,0100,0100,0100,0100,0005,0005,0005,0005,0005,0005,0005,0005,0005,0005,0005,0136,0135,0135,0135
0005,0005,0005,0005,0005,0098,0080,0080,0080,0080,0099,0100,0005,0005,0005,0005,0005,0005,0005,0005,0005,0005,0136,0136,0136
0005,0005,0005,0005,0005,0098,0080,0080,0080,0080,0080,0080,0097,0005,0005,0005,0005,0005,0005,0005,0005,0005,0140,0140,0140
0005,0005,0005,0005,0005,0005,0096,0080,0080,0080,0080,0080,0097,0005,0005,0005,0005,0005,0005,0005,0005,0005,0137,0140,0140
0005,0005,0005,0005,0005,0005,0005,0095,0095,0095,0095,0095,0005,0005,0005,0005,0005,0005,0005,0005,0005,0005,0140,0140,0140
0005,0005,0005,0005,0005,0005,0005,0005,0005,0005,0005,0005,0005,0005,0005,0005,0005,0005,0005,0005,0005,0134,0134,0134,0134
0134,0134,0134,0134,0134,0134,0134,0134,0134,0134,0134,0134,0134,0134,0134,0134,0134,0134,0134,0134,0134,0135,0135,0135,0135
0136,0136,0136,0136,0136,0136,0136,0136,0136,0136,0136,0136,0136,0136,0136,0136,0136,0136,0136,0136,0136,0136,0136,0136,0136