inside:false
objects:none
warps:2,2,pie_cavern_top,59,58
connections:east,jupiter,5
wild:none
conditions:none
configuration:
0138,0138,0138,0134,0134,0134,0134,0134,0134,0134,0134,0134,0134,0134,0134,0134,0134,0134,0134,0134,0134,0134,0134,0134,0134,0134,0134,0134,0134,0134
0138,0138,0138,0136,0136,0136,0136,0136,0136,0136,0136,0136,0136,0136,0136,0136,0136,0136,0136,0135,0135,0135,0135,0135,0135,0135,0135,0135,0135,0135
0138,0138,0137,0005,0005,0005,0005,0005,0005,0005,0005,0005,0005,0005,0005,0005,0005,0005,0005,0136,0135,0136,0135,0135,0135,0135,0135,0135,0136,0136
0138,0138,0138,0005,0005,0005,0005,0005,0005,0005,0005,0005,0005,0005,0005,0005,0005,0005,0005,0005,0135,0134,0136,0136,0136,0136,0136,0136,0134,0134
0134,0134,0005,0005,0005,0005,0005,0005,0005,0005,0005,0005,0005,0005,0005,0005,0005,0005,0005,0005,0136,0136,0134,0134,0134,0134,0134,0134,0135,0135
0135,0135,0005,0005,0005,0005,0005,0005,0005,0005,0005,0005,0005,0005,0005,0005,0005,0005,0005,0005,0005,0005,0135,0134,0136,0136,0136,0136,0136,0136
0136,0136,0005,0005,0005,0005,0005,0005,0005,0005,0005,0005,0005,0005,0005,0005,0005,0005,0005,0005,0005,0005,0136,0135,0134,0134,0134,0134,0134,0134
0134,0134,0005,0005,0005,0005,0005,0005,0005,0005,0005,0005,0005,0005,0005,0005,0005,0005,0005,0005,0005,0005,0005,0136,0135,0135,0135,0135,0135,0135
0135,0135,0005,0005,0005,0005,0005,0005,0005,0005,0005,0005,0005,0005,0005,0005,0005,0005,0005,0005,0005,0005,0005,0005,0136,0136,0136,0136,0136,0136
0135,0135,0005,0005,0005,0005,0005,0005,0005,0005,0005,0005,0005,0005,0005,0005,0005,0005,0005,0005,0005,0005,0005,0005,0134,0134,0134,0134,0134,0134
0136,0135,0134,0005,0005,0005,0005,0005,0005,0005,0005,0005,0005,0005,0005,0005,0005,0005,0005,0005,0005,0005,0005,0005,0135,0135,0135,0135,0135,0135
0005,0136,0135,0005,0005,0005,0005,0005,0005,0005,0005,0005,0005,0005,0005,0005,0005,0005,0005,0005,0005,0005,0005,0005,0136,0136,0136,0136,0136,0136
0005,0005,0136,0005,0005,0005,0005,0005,0005,0005,0005,0005,0005,0005,0005,0005,0005,0005,0005,0005,0005,0005,0005,0134,0134,0134,0134,0134,0134,0134
0005,0134,0134,0005,0005,0005,0005,0005,0005,0005,0005,0005,0005,0005,0005,0005,0005,0005,0005,0005,0005,0134,0134,0135,0136,0135,0135,0135,0135,0135
0134,0135,0136,0005,0005,0005,0005,0005,0005,0005,0005,0005,0005,0005,0005,0005,0005,0005,0005,0134,0134,0135,0136,0136,0136,0136,0136,0136,0136,0136
0135,0136,0005,0005,0005,0005,0005,0005,0134,0134,0134,0134,0134,0134,0134,0134,0134,0134,0134,0135,0135,0135,0134,0134,0134,0134,0134,0134,0134,0134
0136,0005,0005,0005,0005,0005,0134,0134,0135,0136,0136,0136,0136,0136,0136,0136,0136,0136,0136,0136,0136,0136,0136,0136,0136,0136,0136,0136,0135,0135
0134,0005,0005,0005,0005,0134,0135,0136,0136,0005,0005,0005,0005,0005,0005,0005,0005,0005,0005,0005,0005,0005,0005,0005,0005,0005,0005,0005,0136,0136
0135,0005,0005,0005,0134,0136,0136,0005,0005,0005,0005,0005,0005,0005,0005,0005,0005,0005,0005,0005,0005,0005,0005,0005,0005,0005,0005,0005,0134,0134
0136,0005,0005,0005,0136,0005,0005,0005,0005,0005,0005,0157,0157,0005,0005,0005,0005,0005,0005,0005,0005,0005,0005,0005,0005,0005,0005,0005,0135,0135
0134,0005,0005,0005,0134,0005,0005,0005,0005,0005,0005,0157,0157,0157,0157,0005,0005,0005,0005,0005,0005,0005,0005,0005,0005,0005,0005,0005,0136,0136
0135,0005,0005,0005,0135,0134,0134,0005,0005,0005,0005,0157,0157,0157,0157,0005,0005,0005,0005,0005,0005,0005,0005,0005,0005,0005,0005,0005,0134,0134
0136,0005,0005,0005,0136,0136,0135,0134,0134,0005,0005,0005,0005,0157,0157,0005,0005,0005,0005,0005,0005,0005,0005,0005,0005,0005,0005,0005,0135,0135
0134,0005,0005,0005,0005,0005,0136,0136,0135,0134,0134,0134,0134,0134,0134,0134,0134,0134,0134,0134,0134,0005,0005,0005,0005,0005,0005,0005,0136,0136
0136,0005,0005,0005,0005,0005,0005,0005,0136,0136,0136,0136,0136,0136,0136,0136,0136,0136,0136,0136,0136,0134,0134,0134,0134,0134,0134,0134,0134,0134
0135,0134,0005,0005,0005,0005,0005,0005,0005,0005,0005,0005,0005,0005,0005,0005,0005,0005,0156,0156,0156,0136,0136,0136,0136,0136,0136,0136,0136,0136
0136,0135,0134,0005,0005,0005,0005,0005,0005,0005,0005,0005,0155,0155,0155,0155,0005,0005,0156,0156,0156,0005,0005,0005,0005,0005,0005,0005,0005,0005
0005,0136,0135,0134,0134,0134,0005,0005,0005,0005,0005,0005,0155,0155,0155,0155,0005,0005,0005,0156,0156,0156,0156,0005,0005,0005,0005,0005,0005,0005
0005,0005,0136,0136,0136,0135,0134,0134,0005,0005,0005,0005,0005,0005,0005,0005,0005,0005,0005,0156,0156,0156,0156,0005,0005,0005,0005,0005,0005,0005
0005,0005,0005,0005,0005,0136,0136,0136,0134,0134,0134,0134,0134,0134,0134,0134,0134,0134,0134,0134,0134,0134,0134,0134,0134,0134,0134,0134,0134,0134