inside:false
objects:none
warps:5,2,route_1_gate,4,9
connections:south,mar_a_lago,0
wild:none
conditions:none
configuration:
0136,0134,0134,0138,0138,0138,0138,0138,0134,0134,0136
0134,0135,0135,0139,0139,0139,0139,0139,0135,0135,0134
0135,0136,0136,0139,0139,0137,0139,0139,0136,0136,0135
0136,0005,0005,0005,0005,0005,0005,0005,0005,0005,0136
0134,0005,0005,0005,0005,0005,0005,0005,0005,0005,0134
0135,0005,0005,0005,0005,0005,0005,0005,0005,0005,0135
0136,0005,0005,0005,0005,0005,0005,0005,0005,0005,0136
0134,0005,0005,0005,0005,0005,0005,0005,0005,0005,0134
0135,0157,0157,0157,0005,0005,0005,0005,0005,0005,0135
0136,0157,0157,0157,0157,0005,0005,0005,0005,0005,0136
0134,0157,0157,0157,0157,0157,0157,0157,0157,0005,0134
0135,0157,0157,0157,0157,0157,0157,0157,0157,0005,0135
0136,0157,0157,0157,0157,0157,0157,0157,0157,0005,0136
0134,0005,0005,0005,0005,0005,0005,0005,0005,0005,0134
0135,0155,0155,0005,0005,0005,0005,0005,0005,0005,0135
0136,0155,0155,0155,0005,0005,0005,0005,0005,0005,0136
0134,0155,0155,0155,0005,0005,0005,0005,0005,0005,0134
0135,0155,0155,0155,0005,0005,0005,0005,0005,0005,0135
0136,0155,0155,0155,0005,0005,0005,0005,0005,0005,0136
0134,0155,0155,0155,0005,0005,0005,0005,0005,0005,0134
0135,0155,0155,0155,0005,0156,0156,0156,0005,0005,0135
0136,0155,0155,0155,0005,0156,0156,0156,0156,0005,0136
0134,0155,0155,0155,0005,0156,0156,0156,0156,0005,0134
0135,0155,0155,0155,0005,0156,0156,0156,0156,0005,0135
0136,0155,0005,0005,0005,0156,0156,0156,0005,0005,0136
0134,0005,0005,0005,0005,0005,0005,0005,0005,0005,0134
0136,0155,0155,0155,0155,0155,0005,0005,0005,0005,0136
0134,0155,0155,0155,0155,0155,0005,0005,0005,0005,0134
0136,0005,0005,0005,0005,0005,0005,0005,0005,0005,0136